q	Every	Sig
qH	Every Hour	Sig
qAM	Every Morning	Sig
qPM	Every Evening	Sig
qHS	Every Bedtime	Sig
qD	Every Day	Sig
qOD	Every Other Day	Sig
qWK	Every Week	Sig
qMO	Every Month	Sig
q_H	Every__Hours	Sig
BID	Twice a Day	Sig
TID	Three Times a Day	Sig
QID	Four Times a Day	Sig
X_D	Times__Days	Sig
C	With	Sig
AC	Before a Meal	Sig
PC	After a Meal	Sig
HS	At Bedtime	Sig
PRN	As Needed	Sig
UD	As Directed	Sig
AA	Of Each	Sig
QS	Quantity Sufficient	Sig
GTT	Drop	Sig
TBSP	Tablespoon	Measurement
TSP	Teaspoon	Measurement
OZ	Ounce	Measurement
GM	Gram	Measurement
KG	Kilogram	Measurement
LB	Pound	Measurement
ML	Milliliter	Measurement
L	Liter	Measurement
G	Gallon	Measurement
OD	Right Eye	Sig
OS	Left Eye	Sig
OU	Both Eyes	Sig
AD	Right Ear	Sig
AS	Left Ear	Sig
AU	Both Ears	Sig
PO	By Mouth	Sig
SL	Sub-Lingual	Sig
NG	Naso Gastric	Sig
BUCCAL	Cheek/Gum	Sig
PR	Rectally	Sig
PV	Vaginally	Sig
SUPP	Suppository	Sig
TAB	Tablet	Sig
CAP	Capsule	Sig
IM	Intra Muscular	Sig
SQ	Sub-Cutaneous	Sig
IV	Intraveneous	Sig
IC	Intra Cardiac	Sig
INJ	Injection	Sig
STAT	Immediately	Sig
DTD	Dispense Such Doses	Sig
APAP	Acetaminophen	General
ASA	Aspirin	General
DAW	Dispense as Written	Sig
MOM	Milk of Magnesia	General
NSAID	Non-Steroidal Anti-Inflammatory Drug	General
OTC	Over-the-Counter	General
PCN	Penicillin	General
TCN	Tetracycline	General
A2RB	Angiotensin 2 Receptor Blockers	General
ACE	Angiotensin Converting Enzyme Inhibitors	General
SSRI	Selective Seratonin Re-Uptake Inhibitors	General
